#####################
e   # #             #
# ### ##### # # # # #
#           # # # # #
## ## # ### ##### # #
#   # # #   #     # #
# ##### ### # # ### #
#   # #   # # #   # #
# ### ### # ### ### #
#                 # #
# # ##### ###########
# #   # #       # # #
### # # # ### ### # #
#   #   #   # #     #
# ##### ## #### # # #
# #   #         # # #
### ### ########### #
#   # #       # #   #
# ### ##### ### # ###
#               # # s
#####################
