#########################################
e       #     #   #   #                 #
# ##### # # ### ### ### ########### #####
# # # #   #     #           #   # #     #
### # ##### # # ######### ### ### # #####
# #         # # #       #     # #       #
# # # ### # ####### ####### # # #########
# # # #   #     # #   # #   # #       # #
# # ##### ####### # ### # ##### ### ### #
#     #   #                   # #   # # #
##### ### ##### # ############### ### # #
#     #   # #   # #     #   #     #     #
### # # ### # ##### # # ### ### ####### #
#   # # #     #   # # # #       #       #
##### ### # ### ### ########### # # #####
# # #     # #   # #             # #     #
# # ### # # # # # # # ####### ### ##### #
#   #   # #   # # # #       #   #   #   #
# ### # # # ### # ##### # ### ### ### ###
#     # # #   # #   #   #   # # #   #   #
### ### ####### ### # ### ##### ##### # #
#   #   #       #       #         #   # #
# ####### ### ##### ############# # ### #
# #     #   #   #   #           #   #   #
### ### # ##### # # ##### ### ### ##### #
#   #       # #   # #   # #   #     #   #
# ### ### ### # ##### # # ### ######### #
# #   # #   #   #   # #   #       #     #
# ### # ##### # ### # ####### ### #######
#   #   #     #     # # #   # # #   #   #
##### ##### # # ##### # # # ### ##### ###
#   # #   # # # # # # #   #   #         #
### # # ##### # # # # ##### ####### ### #
# #     # #   #   #     #   #         # #
# ##### # # ### ### ### # # # ##### ### #
#     # #   #       #     #   # #   #   #
##### # ##### ##### ####### # # # # #####
# #     #       #     #     # #   # #   #
# ##### # # # ##### ### # # ##### ### # #
#       # # #     # #   # #     #     # s
#########################################
