#########################################
e   # #     #         #   #             #
# ### ### ##### ##### # # ### ### ### ###
#     #         # #   # # #     #   # # #
### # # ####### # ### # ##### ##### # # #
#   # # # #     #                 # # # #
# ####### # ### # # # ##### ##### ### # #
#   # # # # #   # # #       #   #     # #
### # # # ### ######### ### # ### # ### #
# #     #     # #   # #   # #     #     #
# # ### # ### # ### # # # ##### ####### #
#   #   #   #       #   # #   #   # #   #
### # # ### ##### ### ##### # # # # # ###
#     #     #       # # # # #   #     # #
# ######### ####### # # # ### ####### # #
#     #   # #       #   # #     # #     #
####### ####### ######### ### ### #######
# # # #   #         #   # #   #     #   #
# # # # # # ### ##### ### # ### ### ### #
#   #   # # # #           # # #   #   # #
### ### ### # ### ######### # # ##### # #
#     #   # #       # #   #   # # # # # #
# ### ### # ### ##### # # ### # # # ### #
# #     #   # #   #     #   #     #     #
####### # # # ### # ###### ## ##### #####
#   # # # #   # # #     #     #   #     #
# # # # ### ### # # ### # # # ### ### ###
# # #     #       #   # # # # # #       #
# # # # # ### ### ### # # ##### ### # # #
# #   # # #     # #   #       #     # # #
# # # ### # ##### ###### ## # ## #### ###
# # #   #           # #   # #     # # # #
# ##### ####### ##### # ### ### ### # # #
# #         # #     # # # #   #   # #   #
####### ##### ### ### # # # # # # # ### #
# #       #   #     # # #   # # # #     #
# # ####### # # ### # # ### ##### ##### #
# # # # #   # # # #       # # #   #     #
# # # # ### # # # # ### # # # # # # #####
#         # #       #   # # #   #       s
#########################################
