#####################################################################################################
e     # #   #     #       # # #                   #       # # #   #     #     # # # #     # #       #
# ##### ### ##### # ####### # ######### # ############# ### # # # ##### ### # # # # ### # # ### ### #
#     #     # #               # #   #   #       #     #     #   #     #     # #   #   # #       # # #
# ##### ##### # ########### ### # # ### ### ######### # ### # ### # ### ##### ### # ### ### # ### ###
#           #   #       #         #     #       #         # # # # # #   #         #   # #   # #     #
# # ######### ### # ### ######### ##### ### ########### ### ### ### # ##### ####### # # ### # # # ###
# #       # # #   # # # #   #   #   #     # # # # # # #   #   #       #     #   #   #   # # #   # # #
# ####### # # ####### # # ### ########### # # # # # # # # ############### # # ####### # # # ####### #
#       # #     #   #           # #   #   # # #       # # # #       # #   #     #     # #       #   #
######### # ####### ### # ### # # # ### ### # # ### ##### # # ##### # ######### # # ##### # # ##### #
#       # #   #       # # #   #     #     #   # # # # # #   # # #       #   #   # # # #   # #       #
### ##### ### ### ############# # ### # ####### # # # # ### ### ##### ##### # # ### # ####### # # # #
#         #       # #   # #     #   # #     #     #   #   #       #   #   #   # # #   #       # # # #
# # # # ### # # # # ### # # ##### ##### ######### # ### # ### ##### ##### # ##### # ### # ##### #####
# # # #   # # # #   #     # #     #   # # # # # # # #   #     # #     # #   #   # # # # # #       # #
######### ### ##### ### ### # ### ### ### # # # # ####### ##### # ### # # # # ### ### ### ######### #
#       #       #   #       # #   # #             #     #       # #       #     # #               # #
### ### ### ##### # # ##### # ### # # ### ##### ##### ### # # ############# ##### # # ### ##### ### #
#   # # #   # # # #   #   # # # # #   # # #   # #     #   # # # #       # #     # # #   #     # #   #
##### # ### # # ### ##### ##### ####### # # ####### ### # ##### # ####### ### ### ### # # # # ##### #
#   #   #   # # #       # #   #   #   #       # #       # # #     #     #         # # # # # #   # # #
### ### ##### # ### # ### ### ### # ######### # # ### ##### ### ####### ### # ##### # # ######### # #
# #     # #   #   # # # #         #   #   #     # # #     #       #     #   #         # #     # #   #
# # # ### ### # # # # # ####### # # ### ### # ### # # ### ##### # # # # ########### ### # ### # ### #
# # # #   #     #   #   #     # #           # #     # # #       #   # # #     # #   #   #   #       #
# # ### ############### ### ### # # # # ### ### ####### # ############### # # # # # ### # # # ##### #
#       #   # #     #         # # # # # #   #       #     #     #   # #   # # # # # #   # # #   #   #
# ##### # # # # # ########### ##### # ######### ### ##### # ##### ### # # ### # # ##### # ### # #####
#   #   # #     # #   # # # #       # # #     # #     # # # # # # #     # # #   #   #     # # #     #
##### # ####### ##### # # # ####### ### # ### ##### ### # # # # # # ##### # # # # # # ##### # # #####
#     # #         # #   #     # # #   # #   # #     # #     #       # # # # # #   # #     #   #   # #
# # # ####### # # # # # ### # # # ### # ### ######### ##### # ### ### # ### # ### ##### ### # ### # #
# # # #       # # #   # #   #     #   #   #       # #         #   #   # #   # #   #     # # #   #   #
### # ### ### ### # # # ######### # ##### ### ### # # ##### # # # # ### ### ####### # # # # #########
#   # #     # #   # # # #   #       # #         #   #   #   # # #             # #   # # #           #
### ####### # ### # ### # ##### # # # # ### ### ##### ##### ####### # ##### ### ########### ####### #
#         # # #       #     #   # # #   # # #   #         #   #     # # #           #   # #   #     #
# ############### ### # ##### ### ### ### # # # ### # ### ##### ### # # # # # ##### ### # ######### #
#   #       # # # #   # #     #   # # #   # # #     # #     # # #   # #   # #     #     #   # #     #
# ######### # # ### ### ### ##### # ##### # ### # ### ####### ########### ### # ##### ##### # ### ###
# #   # #         # # #   # # # # #       # # # #   #   #           #     #   #   #     #       #   #
# ### # ### ####### # # ##### # # ##### ##### ############# # # # # ### ### ##### ##### ### ####### #
#       #   #       #       #                 #         # # # # # # #     # #   #     #       #   # #
##### ### ######### # ######### ### # # ####### ### # # # # # ### ##### ### # # # ######### # # # # #
#   #     #     #   # #     #   # # # #       #   # # #   # # # # # # # #   # #   #         # # # # #
### ### ##### # ### ##### ##### # ####### ### # # # # ### # ### # # # ### # # ### ####### ####### # #
#   #         # #   # # # #   #   #     # # #   # # # #     #   #   #     # # # # # # #         #   #
# # # ######### ### # # # # ####### ####### ### ########### # ### ### ### ##### ### # ########### # #
# #     # #       #       #   #   # #   #         #           # #     #       #     #         #   # #
### # # # ######### # # ##### # # # # # ##### ##### ### # ### # ######### ####### # # ####### ##### #
#   # # # #         # #       # # # # # # #       # #   # # #   # #     #     #   # #   # # # #     #
### ##### ### ### # # ### ##### ### ### # ### ##### ### ### ### # ##### # ### ### ### ### # ####### #
#   #     #   #   # # #     # #   #             #   # #   #         # #   #     #     #     #     # #
# ### # ######### ##### ##### # # # ####### # ####### # ##### ### ### # ### # # # ### # # # # #######
#     # #             #     #   #         # # #         #     #       #   # # #   #   # # #   # # # #
# ########### ##### ### ### # ### ################# # # # ### ### ##### ### # ####### ### # ### # # #
#     # #     #       #   # # #     #   # #   #     # # #   # #   #       # # #       # # #         #
### # # ##### # ######### ##### ### # ### # ######### ####### ####### ######### ### ### # ##### #####
#   # #     # # # #   #       # #   #   #   #       # # # #     #           #   # # #       # #     #
# ### # ##### # # # ### # # # ### ##### # # # ##### # # # ####### ##### ### ##### # ######### ##### #
#   # #   #   #   # #   # # #   #     #   # #   # # # # # # #   # #     #   # #       #   #     #   #
# ### # # # ### ### # # ##### ##### ### # # ### # # ### # # ### ### # ####### ### ### # ### ####### #
# #   # # #   #   #   # # #     # #     # #   # #           #   # # # #   # #   # # # #   #   #     #
### ##### ##### # # ### # ##### # # ############# ####### ### # # ####### # # ### # # # # # ##### ###
#       #   # # # #   #   #       #         #   # #   #       #   #   #     # # # #   # # #         #
### ####### # ### ##### # ##### ####### ### ### ##### ##### ####### ### ### # # # ####### ##### ### #
# #   #   #       #   # # # #       # # #       #               #     # #         # #           #   #
# # ##### # # # # ### # # # ####### # # ##### ### ####### # ##### # ############# # ####### # ### # #
# #         # # #     # # #   #       #   # #   #       # # #   # # #   #   #     #   #     # #   # #
# # # ### ### ##### # # ### # ##### ####### ### # ############# # ### ##### # ### ### ### ### #######
#   # # # # #   #   # # #   #         # #         # # # # # #     #       # #   #   #   # # #       #
# ### # # # ### ####### # ####### ##### # ### # ### # # # # ### ##### ##### # ####### ### # ### #####
# # #   # #       #   # # # #       # #     # #         #   # #           #       #   #   #     #   #
### ### ### # ####### ##### ### ### # # # # ######### ### # # ##### ##### ####### # # ### ### ### # #
#   #     # #     #       # #     #     # #         #   # #           #         #   # # # #   # # # #
# ### ##### ### # ##### ### ############# # ### ### ######### # ### ##### ### ### ### # ### # # # ###
# # # # # # #   #                 #   #   # #   #   # #   # # #   #   # # #   # # # #       # # #   #
# # # # # # # ##### ### # ##### ##### # # ######### # ### # # ######### ### # # # # ### # ##### ### #
#   # #   # #   #   #   #   #     #   # #   #         #           # #     # # #   # #   #         # #
### ##### # ######### ######### ##### ####### # ### ####### ##### # # # ##### # ### # ### ### ### # #
#   #             # #   #     #     #     #   # #     #   # #   # #   #     #       #   # #     # # #
# ##### ##### # ### # ####### # ### # ### # ######### ### ##### ### ##### # # ##### # # # # ### # # #
#   # # #     # # #         #     #   #   #     # #         #     # # # # #   #   # # # # #   # #   #
# ### # ######### # # ### ####### ### ##### ##### ### ##### ### ##### # ### ### # ### ####### # #####
#     #   # #       #   # #         # #   # #   # # #     #   #   #       # #   #   # # # #   #   # #
### ### ### ### ##### ######### ##### # ####### # # # ####### # # ##### # # # ### ### # # ##### # # #
#   #   #     #     # #   #   # #       #         #         #   # #     #   #   #     # #   #   #   #
### ### ##### ######### ##### # ##### ### ##### ### # # # ### # ##### ### ##### ### # # ### # # ### #
#   # #       # #     #           # #   # # # #   # # # #   # # #     #     #   #   # #   #   #   # #
### # # # # ### ### ### ### ##### # ### ### # # # ### # ##### # ##### ### ####### ##### ####### #####
#       # # # #     # # #     # # #     #   # # #     # # # # # # # # # # #     #   #   # #       # #
####### ##### # ##### # ### ### ########### # ### ####### # ##### # ### ### ### # ##### # ##### ### #
#   #     # #     #       # #   # # #   #         # #   #           #   # # #     #       #   #     #
# ### ### # ##### ### ### ### ### # ### ##### ##### # ### ######### # ### ##### ### # ### # ### #####
#   # #   #   #         # #             #   #   #   #   # #     # # #   # #       # # #     #   # # #
# ### ##### ### ### ##### ### ######### # ### # # ##### # ##### # ##### # # # ### ####### # ### # # #
#             #   #     # #         # #   #   # #         # #           #   #   # #   # # #     #   #
# ####### ### # ### ##### ### ####### # ####### # ##### # # ### ####### # ##### ### # # # # ####### #
#       # #   # #       #   #     #                 #   # #           #       # #   #     #         s
#####################################################################################################
