#####################
e   # #       #     #
# ### # ### # # # # #
# #     #   #   # # #
# ## ## # # # ### ###
# #   #   # #   # # #
# # # ### # # ### # #
#   #       # # #   #
####### ##### # #####
#               # # #
### ### ####### # # #
#   #         #     #
# ### ### # ####### #
#   #   # #       # #
### # # ####### # ###
#     #   #   # #   #
# ### ### # ##### # #
#   #   #         # #
### # # ##### # ### #
#   #       # # #   s
#####################
