#####################################################################################################
e     #   # #           # #         #           # #     # #     #     #                     #   #   #
# ### # ### # ##### # ### ######### # # # ### # # # # ### # # # # ### # # ### ### ####### ##### # # #
#   # #     #     # #   # #     # # # # #   # # # # # #     # #     # # #   # #       #     #     # #
# ### # ####### ####### # ### ### # # ### # # # # ### # # ########### ### ##### # # ### # ### # # # #
# #           #     #       #     #   # # # # #     #   # #           # # #   # # #   # #   # # # # #
### ####### ######### # ####### ### # # ##### ### ### ##### ### # ### # # # ### ### ##### ### #######
#   # #   # #   #   # # # #       # #     #   # # # # #   #   # # # #         # #     #   #     #   #
##### ### # # # ### # ### # # ####### ##### ### ### ##### ##### # # ### ##### ### ### ### ### ### # #
# #           # # #   #   # #   # #   # #   #           #   #   # #       # # #   #   # # # # # # # #
# ##### # ##### # # # # ##### ### # ### # ### ### # # # # ##### ### ### ### ### ##### # # # # # ### #
# #     #   #   #   # #     #   #   #       # #   # # #   # # # # # #         # #     #             #
# ######### ### # ##### # # # ####### # # # # # ### ### ### # ### ##### ### ### ####### # # ##### # #
# # # #   # # #         # #     #   # # # # # # #   # # # #   # #   #   #   #         # # #     # # #
# # # ### # # ##### ### ####### # ### ### ### # ### # ### # ### # # ######### ### # ##### ####### ###
#     # #   #       #       #   #   # #       # #     #       #   # #       # # # #   #         #   #
# # # # ####### ##### ######### ### # ##### # # ##### ##### ##### ##### ##### # # # ##### ######### #
# # #     #       #       # # # #   # #   # # # #   # #       #       #     # # # # # # # #   # # # #
# ##### ####### ##### # ### # ### ### # ##### # # # # # ### # ### # ##### # # # # ### # # # ### # # #
# #     #   #       # #       #   #   #     # # # #     # # # #   #       # #   #     #     #     # #
# ### ### ############# # ### ### # ### ### ####### ##### ######### ####### # # ### ### ######### # #
# #         #           #   #   # #       #   #             #       #     #   # #     # #       #   #
# ######### ### # # ##### # # # # ### ####### # # ##### ####### # # ##### # ### ### ##### ### ### ###
#   # #     #   # #     # # # # #     # #   # # #     #   # # # # # # # #     # # # #     #     #   #
# # # ### ### # ##### ##### ####### # # ### ### # ######### # # # ### # ### # # # ##### ### # # # ###
# #   #       #     #     # # #   # # # #     # #   #     # #   # # #     # # #   # #   #   # # #   #
# ##### ########### ### # # # ### ##### # ### # ### # ##### ##### # ##### ### # ### ##### ### # # # #
# #   # # #           # # # #     #   #   # #   #     # #   #   #       #   # # #   #   # # # # # # #
# ### # # # ### # # # ######### # ### ### # # ### # # # # ### # # ### ### ##### # ### ### # # ##### #
# #   # # # #   # # # #     #   # # # # #   # #   # # # # #   # # #           # # #         #       #
# # ##### ####### ### # ### ##### # # # # # # ##### ### # ##### # ### ########### # ### # # # ##### #
#     # #       # #       # #   #   # #   # # #       #           # #       #     #   # # # # # #   #
##### # ##### # # ##### ### ### # ### # ##### ### ########### ### # # # # ### ### ####### ### # #####
#       #   # #     #     # # #       #   #   #   #             # #   # #   #   #     #     #     # #
# ### ### # # # # ### ### # # # ##### ### ######### # ##### ### ############# # ### # ##### # ### # #
#   # # # # # # # #     # #   #     #     #       # #     #   # # #   #   #   #   # # # #   # #     #
### ### # ######### ######### # # ##### # # ### # ##### # # ##### ### ### # ### ### # # # ### ##### #
# #   #   # #       #   # #   # # #   # # #   # #   #   # # #   #   #   #     # # # # # # # #   # # #
# ### # ### ### ##### ### # # ### ### # ### ### # ##### # ### ##### ### # ####### ### # ### # # # # #
#     # # # #     #     # # # # # #   # #     # # #   # #                 # #     #   #   # # # #   #
##### # # # ##### # ##### ##### ##### # # ####### # ####### ##### # ### ### ### ### ### ### ####### #
#           #   #     #         # #         #   #       #       # # #     # #   # #   #       #     #
############# ### ####### ##### # ### # ### # # ##### # ######### # ### ### ### # # # # ####### ### #
#         # #   # #   #       #     # #   #   #   #   # #   #   # # #   #   #   # # #       # # # # #
# ####### # # ### # # # # ### ##### ##### ##### ########### # ####### ##### # # # ##### # ### # # ###
#   # #       # # # # # #   #     #           # # #       #   #   #       # # #         #   #       #
### # ### # # # # # # ### # ### ####### # ### ### ### ####### # # # ##### # ### # ####### # #########
#   #     # #     # #   # # #     #   # # # # # #     #       # #   #     # #   #   #   # #   # #   #
##### ####### ##### ##### # ######### ### # ### # # ####### # ### ######### ##### # ### # ##### # ###
#   # #     #       # #   # #   #     #     # # # # #   #   #       # #   # # #   #     # #     #   #
# ### # ######### ### ##### ### ### ##### # # # # # # ##### ##### # # # ### # ####### ##### # ### ###
#           # # # #   # #           #     #     # #     #     #   #   #         #   # # #   #     # #
# # # ##### # # ##### # # ### # # ############# # ### # ######### # # ### # ##### ### # ####### # # #
# # #   #   #   #       # # # # # #   # # #         # #         # # #     # #       #   # # # # #   #
# # ####### # # # ####### # ##### # # # # # ### ################# ### ### # ### ######### # # ### # #
# #   #       # #   #   #   #   #   # #   # # #       #             # #   # #           # #       # #
####### ### ### # ##### # # ### ### # ### ### ### # ### # ### ############# ### ##### ### ### # ### #
#       # # # # #         # # #   # #       # #   # #   #   # # #           #       #   # # # # #   #
# # ##### ### ########### ### ### # ### ##### ##### ##### ### # # ####### # # ### ### # # # ##### ###
# # # #           #       # # #     #     #                 # #     #     # # #   # # #       #   # #
# # # ### # ### ##### ### # # ####### ####### ##### # # ##### # ### ### # # # ##### ######### ### # #
# # #     #   # # #     #   # # # #   # #       # # # # # #   # #   #   # # # # # # #         # #   #
### ##### ### # # # ##### ### # # # # # # ##### # # ##### # # ##### ### ####### # # ### ####### ### #
#   #       # #   #     # #       # # #   # #     #     # # # #   #   #     #     #       # # #     #
# # # ### # ### # # ######### ##### ##### # # ### ### ### ### # # # ##### # # # # # # # # # # # #####
# # #   # #   # #     # # #   #   #     # #     #   # #   #     # # #   # #   # # # # # #       #   #
# ### ################# # ### ### # ### ######### # ### # ######### # # ### # ### ####### ##### ### #
#       #       #       #           # #   #       #   # #       # #   # # # #   #   #         #     #
### ### ### ####### ### # ####### # # ######### ### # # # # ### # ### ### ######### # ######### ### #
#     #   # # #     #       #   # #       #     #   # # # # # #   #           # #   #   #         # #
# ### ##### # # ### ####### # ######### ##### # ############# # ##### ### ##### ### # ### # ##### # #
#   # # #   #   # #   #     #       # # #   # # #   # #           #   # #   # #     #   # #   # # # #
### ### # # # # # ####### ##### # ### ##### ### ### # # ##### # # ### # ### # ### ### # ### ### ### #
#   #   # # # #   # #     #     #       #         #     #     # # #     # #   #   # # # #       #   #
# ##### # ### ##### ### ####### # # ####################### ######### ### # # # ### ### # # ####### #
#   #   #     # #         # #   # #   #   # # # # # #   #       #       # # # # #   #   # #   #     #
# ### # ####### # ##### ### # ### # # # ### # # # # ### # ##### ####### # ##### # # # ##### # ### # #
#   # #               # # # #   # # # # # #                 # # #             #   # #     # # # # # #
# ####### # ### ####### # # # # ### ### # ########### ##### # ####### # ########### ### # ### # # ###
#   # #   # # #   #       #   # #     #     #     # #     #   #   #   #       #     #   # #   #     #
### # ### ### ##### ### # # ### ### ### ####### ### ### ### ### # ######### ##### ### # # ######### #
# #   # #   #       #   # # # # #     #           #   #   #   # # #   #   #   #     # # # #     #   #
# # ### ##### # ### ### # ### # # # ##### # ##### # # # ### ##### # ### ##### ### # # ##### ### ### #
#           # #   # #   #     # # #     # #     #   # #   # # #     #           # #           #   # #
# # ### # ### ######### # ############# # ### ####### ### ### # # # ##### ####### ### # # ######### #
# #   # #   #         # # #       #   #     #       #           # #   # # # #   # #   # #   #     # #
# ####### # ####### # ######### ### ### ### # ####### ##### ### # ##### # # # ########### ### # #####
#     # # # #       # #   #     #         # #   #       # # #   #   #       #       # #       #     #
# ##### # ##### # # # # ##### # ### ################# ### ### # # # # # # # ### ##### ######### # # #
# #   # #     # # # #   #     #   #       #       #       #   # # # # # # # #   #     #     #   # # #
### # # # ############### ########### ##### ########### ##### ### ##### ##### ##### ### ########### #
#   #   #   # # #   # #     #     #       #           #   #     #           # # #     #     #       #
# ##### # # # # ### # ### # ### ### ####### ### # # ### # ######### ######### # # ######### # # # # #
# #       # # #   #   #   #             #     # # #   # # # #   # # #     #   #   # #     # # # # # #
# ######### # ### # ### ##### ####### # ### # # # # ##### # ### # ####### # ### ### # ### # # ### ###
# # #     # #     # # # # # # # #     #     # # # #   #           # #   #   # # # # #   #     # #   #
# # # ##### # ##### # ### # # # # ##### ##### # ### ####### # ### # # ##### # # # # ### ####### ### #
#       # # #           #   #   # #   #   # # #   # #       # #   # #           #       #     #     #
# # # # # # ### ##### # ### # # ##### ### # # ########### ##### # # ### # # ### ### ### ### ### # # #
# # # #   #     #     # #     #   #       #       #           # #     # # # #         # #       # # s
#####################################################################################################
