#####################################################################################################
e   #       # #   #     #   #   # #     # #                   #   #   #   #   #       #       #     #
### # ### ### ### ##### # ##### # # ### # # # ### # # ##### ##### ### ### ### ##### # # ### # # # # #
#     #   # #       #   # #       #   # # # #   # # # #       #         #     #   # #   #   # # # # #
# # ### # # # ##### ### # # # # ### ### # ### # ##### ##### # ##### ### # ####### ### ####### # ### #
# # #   # #     #   #     # # #     #       # # #   #     # #     # #         # # # #       #     # #
# ##### ########### # # ####### ### # ##### # ### ####### ##### # ### ### ##### # # ### # ### ### # #
# #   # # #   #   # # # #     #   # #   # #       # # # #   # # # #   # #     #   #     # #   #   # #
##### # # # ### # # # # ### ##### ####### # ####### # # ### # ### # ### ####### # ##### # ### ##### #
# #   #       # # # # #   # # #     #   # # #   #       # #     # # #     #     #     # #   #   #   #
# ### # # ### # # # # ### # # ##### # # # # # ### # # ### # ### # # ##### # ##### # ##### ##### #####
#   #   # # # # # #   #       #       #   #     # # # #     #   # #   #   #   #   #   #       # #   #
# ##### # # ### ####### # # # ########### # ####### # # ### ### ##### ### ####### # # ### ##### ### #
#       #     # # # #   # # #   # # #   # # #     # #     #   # #   # #   # #     # # #   #   #   # #
####### ### ### # # ### # # ##### # # ##### # ####### # ### ### # # # ### # # # ##### # ### ##### # #
# # #   #   #     #     # # # #     #   #   #     #   #   # # #   #   # # # # #   # #         # # # #
# # ### ######### ### # ##### ### # # ##### # ####### # # # # # ### ### # # # ### # # ##### ### ### #
# # #   #       #     #   # #     # # #   # #       # # # # #   # #       #     # # # #     # # #   #
# # # ##### # ### # ##### # # ### ### ### # ### ### ##### ### ### # # # # # ### ### ##### ### # # # #
# # # # #   # #   # #     # # #   #   #     # #   # # #   #   #   # # # # #   #   # #         #   # #
# # # # ### # ### # # ##### # ## #### ### ### # # # # ### ### # ### # ### ### ### # ##### # # # # ###
# # # # #   #   # # # # #     #     # # # #   # # #   #   #   #   # # #         #   #   # # # # #   #
# # # # ### ### # ##### # ######### # # # # ### # ##### ##### ### ####### ### ####### # ##### ### # #
# # # # # # #   #   #     #             #       #   #   #   #   #       #   #   #   # # #   # #   # #
# # # # # # ####### # ### # ### ### # ### ### #### ###### ######### # # ##### ### ### ### ### ##### #
#   #   #       #       # # #     # #   # # #       #   #   # # #   # # #   #       #     # #       #
# # ### ####### ####### ### ########### ### ####### # ### # # # # ##### ### # ### ####### # # # #####
# #     # #     #         #     # #   #       #     #     #   # #   #   # #   #     #         #     #
# ####### ### ### # # # ##### ### # # # ### ##### ####### ##### ### # ### ### ### ######### # # # ###
#     #       #   # # #   # # #     # # #           #       #     #         # #     # #   # # # # # #
### ### ### ##### # ### ### ##### ### # ### ######### ##### # ##### ######### ####### ### # ####### #
#         #       # # # # #         #   #         # # #       # #           # #     #             # #
### ### ### ### ##### # # ### ### ### ### ##### # # ##### # ### ### ### ### ####### # # ### ####### #
#   # # #   #     #           #   #     #   #   #       # #           # # #         # # # #     #   #
# # # ######### ########### ### ### ######### ##### # ### # ### ######### # # ### ##### # ### ### ###
# #   # #   #   # # # #     # #   # #   # # #   # # #     # # # #   # #   # # #   # #   # #   #   # #
# # ### # ### ### # # # # ### # ####### # # # ### # ##### ### # # # # # ### # # # # ### # # # ### # #
# #   #           #     # #     # #   # #       #             #   # # #       # # # #     # # #     #
##### ##### # # ############# # # # ### # # # ### ### # ### ######### # ### # # ### # ####### # # ###
# # # #     # #     #   #     # #   #     # # # # #   #   #   # # # #     # # #     #     #     #   #
# # ######### ### # # ### ### # # ##### ####### ##### ####### # # # # ######### ##### ########### ###
#     #     # # # #     # #   #     #       #   #         #   # #   # # #   #   #             # #   #
### # # # # # # ### # ### # ### ##### ####### ### ### ######### # # ### ### ####### # ##### ### # ###
#   #   # # # #         # #   #     # #       #   #     #         #   #     #     # #   #   #       #
# ####### # ##### ##### # # ### ### # # ### ### # ### ### ### ### ##### ### ### ############### # ###
# #   #   #   #       # # # #   # #   # #       #     # # # #   #   # # #       #     #   #     #   #
### ### # ######### ### # ### ### # ####### ####### # # # # ### # ### # # ##### # ##### ##### # # ###
#       #   #       # #     # #   #     # # #     # #       #   #         #     #         #   # #   #
# ### # ### # ##### # ##### ### ##### ### ### ####### ### ######### # ##### ### ### ### # ######### #
# # # # #   #     # # #   #   #               # #     #     #             # #     #   # #       # # #
# # # ### ### ### # # # # ########### ### #  ## ### ##### ### ### ####### # # ##### # # ##### # # ###
# # # #         # #   # #         #   #       #   # #   #       #   #   # # # # # # # # # #   #     #
# # ### # ##### # # ####### # ### ### # ### ### ##### # ########### ### # ### # # ### ### ####### ###
# #     #     # # # # #     #   #   # # #     #   #   # #     #       #         #     # # #   #     #
##### ####### ##### # # ##### ########### # ### ##### # ### ##### ####### ### ##### # # # # # ### ###
#         #       #     #     #       # # # # # #   # #   #   #   #     #   # # # # #     # #       #
# ### ########### ### # ### # ### ### # ### # # ### # ####### ### # ######### # # # # ### ### ### ###
#   # #       # # #   #   # # #   #   # #       # #       #     # #   # # # # #     # #   #   #   # #
##### ### ##### ### # ##### ##### ##### ##### ### # # # ####### ### # # # # # ##### # ######### ### #
# #   #       #     #   #     # #   #       #   #   # #         #   #       #       # #   #   #   # #
# ##### ### ### ##### # # # # # # ####### ### ### ####### # ### ########### ####### # ### # # # ### #
#     # #       # #   # # # # #   #     # #       # #     # #     #       # #   #   #     # #   #   #
# # ### # ####### ### # ### ### ##### ### ##### ### # ### ### ### ##### ### # ##### ########### # ###
# #     # # # #         #     #   # #        #   #     #   # # # # #   #     # #   #         #     #
### ### ### # #### #### ##### ### # # ####### ### # ### ####### ### # # # # ### ### ### ####### #####
# #   # #                 # # # # #               # #   # #     # # # #   #   # #   #               #
# # # # ########### # # ### # # # ### ######### ### # ### ### ### # # ### ##### ############# # #####
#   # # # #   #     # # # #           #   #       # # # # #     # #   #   #           #       #     #
######### ### # # ##### # ####### ### # ######### ##### # # # ### # ####### # ### ### ### ##### # ###
# # # #         #     #   # # # #   #   # #   # # # #     # #       #   # # # #     # # # #   # # # #
# # # ####### # ##### ##### # # ### # ### ### # ### # ######### # # # ### # # ##### # # # ### ### # #
#         #   # # #       #         #   # #       # #       #   # #     # # #     # #         #   # #
####### # # ### # ### ##### ########### # # # # ### # ##### ### ######### ### ##### # # ### # ### # #
#   #   # # #   # #         # # #   #     # # # # #     #   # # # #         # #   # # # # # #   # # #
### # ##### ##### ####### # # # # ##### ### ### # ### # ### # # # # ### ##### # ##### ### ####### # #
#         # #   #     #   #         #   #   #         # # #         # #   #         #     #         #
### # ### ##### # # # ##### ####### # ##### # ### ####### ##### ### # ##### ####### ####### # #######
#   # #     #     # # #     # #     #   # # #   #     #   #     # #       # #           #   #     # #
# ##### ### # ### ##### ##### # ##### # # ##### ### ##### # ### # ######### ### ############# # # # #
#     #   # #   #           # # #     # #     # # # #       # #         #   #   # # #         # #   #
##### ##### # ### # # # ### # ### # ######### # # # ####### # ################# # # # ##### ### #####
#     # #   # # # # #     #       #       #       # #         #   #       # # #   #       # #   #   #
# ##### ### # # ### ##### # # # ### # ##### ######### # ####### ### ####### # ### # # ########### ###
#   #   #   # #   # # #   # # # #   #           #   # #   # #     # #   #         # # # #   #   # # #
# ### ##### # ### # # ####### # # # ####### ### ### # ### # # # # # # ### # ### ##### # # ##### # # #
#   #     #   #   #       # # #   #     # # #   #   # # #   # # # # #   # #   #   #       #   #     #
# # ### # # ### # ##### ### # # ### ##### ### # # # ### # ### ##### ### # ### ##### ####### ####### #
# # #   #   #   # # #     #   # # # #       # # # #                     # # # #       #   #     #   #
### ### # ####### # ### ######### ##### ##### ### ### ######### ######### # ####### ### ### ### # # #
#   # # #   #     # # #   # #   # # #       # #     # #   #     #     # #   #     # # # # #   # # # #
### # # ####### # # # # # # ### # # ### ####### ### # # ######### # ### # ####### # # # # # ### ### #
#     #     #   # #     #     # #     # # #   # #   # #   # # #   # # #     #       #       #     # #
# # #### #### ####### ### ##### ### # # # # ##### ##### ### # ### ### ### # ########### ######### # #
# # # #           #   # #     # #   #       # #     #       # # #     # # # #     #     #           #
### # # ### ### # ##### # ### # # ####### # # ##### ### # # # # # ##### # ### # ### # ##### # ### ###
#   #   #   # # # #       #   #     #   # #   # #     # # #       #   #     # #   # #   #   # #     #
# # # ####### # # # ### # # # # ### # ##### ### ### ##### # ####### ### ### ### # ####### # ##### ###
# # #   # #     #     # # # #     # #     #   #   #   # # #   # # #     #     # # #     # #   #   # #
##### ### ##### # ### ######### ### # ### ### # # # ### # # ### # # # ### ####### ##### # ### ### # #
#     #         # #     #         # # #         #         #   #     #   #                 #     #   s
#####################################################################################################
