#####################
e     #     #       #
# # ### # ### ### ###
# # #   #     #     #
# ### ##### ### ### #
#   #     # # #   # #
# # # ####### ### # #
# #     #     #   # #
##### ### # ##### ###
#       # # #   # # #
# # ##### ### ##### #
# #   #   #   # #   #
# ####### # # # ### #
#       #   #       #
### # ### ##### # # #
#   # # #     # # # #
##### # ######### ###
# # # #     # #     #
# # # # ### # # # ###
#         #     #   s
#####################
