#####################
e           #   # # #
### # ### # ### # # #
#   # #   #   #   # #
# # # # # ####### # #
# # # # # #   # #   #
### # ##### # # ### #
#   #   #   # #   # #
##### ### ##### ### #
#         #     #   #
# # ####### # # ### #
# #   # # # # #     #
# # # # # # ##### ###
# # #         #     #
# # ### ##### #######
# #   #     # # #   #
# # ### ####### ### #
# #   #     #   # # #
# ####### # ### # # #
#     #   #         s
#####################
