#####################################################################################################
e # #   #             #         # # # # # #   #       #     #     # # #     #           #   #       #
# # # # # # ### ##### ######### # # # # # # # ####### ### ####### # # ### ##### # # ### # # # ### # #
# #   #   # #   #       #   # # #       #   # # #             #           # # # # # # #   #     # # #
# ### # # ##### # # # # # ### # ### ##### # # # ### # ### ####### # ##### # # ### ### # ##### # ### #
#     # #   #   # # # #       #       #   # # # #   #   # #       #   #         #     #   #   # # # #
# ########### # ######### ##### # ### # ####### # ##### # # ####### ##### ######### ### ######### # #
#   # #   # # # # # # # #   #   #   #     #   # # #     # # #         #       # #     #   # #       #
# ### # ### # # # # # # # ### # ##### ### # ### ### ######### # ##### ### ##### # ####### # # # # ###
#         #   #   #     #   # # #     #         #   #   #   # #     #   # #   # #     # # #   # # # #
# # ############### # # ### # ##### ##### ##### # ### # ### # ####### # # # ### # ### # ##### ##### #
# #     #     #   # # # #       #   # # #       #     #             # # #     #             # #     #
# ### # # # ### ### # # ####### ##### # # # ####### # ####### ##### ########### # ### ############# #
# #   #   # # #   # # #     # # #   #     #         # # #   # #           #   #     #   #       #   #
# # ### ### # # ######### # # ### # ####### ### ### # # # # ##### ### ####### ######### ### # ### ###
# #   #   # #       #   # # # #   #   #     #   #   # # # #     #   # # #           # # #   #   #   #
### ##### ##### ### # ##### # # ### ##### ####### ### # ### # ######### ##### ### # # # # # ##### # #
# #   #     #   #   # # #   #   #     # # #   # #   # #   # #         #     #   # # #     #     # # #
# ##### # # # ### # # # ### # ##### # # # # # # # ##### ### ####### ##### ##### ####### ##### ### # #
# #   # # # #   # # # # #     # #   #     # # #     #   # #     #   #           # # # # # # #     # #
# ### ########### ### # ### ### ####### # # # ### # # ### # # ##### # ##### ##### # # ### # ##### ###
#                 #           #         # # # # # #     # # #   #       # #       #     #   #   # # #
##### # # ### ### ####### ####### ##### ### ### # # # ### ### ######### # # # ##### # ### ##### # # #
#   # # # #     # # #     #   # # #   #   #   #   # #   #         #       # #   # # #               #
# ### # ### ####### ### ##### # ### ### # # ### ### ##### # ##### ########### ### ##### ### ##### ###
#     #   #   # # #   # # #           # #         # #   # # #   #         # #       #   #   #   # # #
# # # ##### ### # # ##### ########### ##### ####### ### # ### ####### ##### # # ### # ### ##### # # #
# # # #   # #   # #   #     #   #         #       #     # #         #     #   #   #   #     # # # # #
# ### # ##### # # # ### # ##### # # # ##### ########### ### ##### # ### ################# ### # # # #
#   #         #         # # # #   # #   #   #   #   #       # #   #         #   #       #       #   #
####### ######### ### ### # # # ##### # # ### ### ### ##### # # ##### ### ##### # # ### # ### ### # #
#   #     #   #   #   #       # # #   # #           #   #     #   #   # # # # #   # # # # #   #   # #
### ##### ### # ### # ### ### # # # # ### ### ####### ### ############# # # # ### ### # ### ####### #
#         #     # # # #     # # #   #     #       # # # #   #   #   #                 # #   #   #   #
### ########### # ######### # ##### ##### # ####### ### # ##### ### # # ### ### ######### # ### # ###
# #   # # #     # # # #     # #     #   # #   # # # # #       #   # # # # #   # #     #   #   # # # #
# # ### # # ### # # # ### # ##### ##### ####### # # # ####### ### # # ### ##### ##### ##### ### ### #
#     # #     # #       # # # #         #   # # #     #         # #     #   #   # #   #   #         #
# ##### # ##### ### # ####### # ### ##### ### # ##### # ######### # # ##### ##### # ### ##### # #####
#     #     # #     #           # #   #         # # #     #   #   # #               # #   #   #     #
##### # ##### ### ####### # ##### # # ####### ### # ## ## ### ### ### ### # ### ##### # # # ### #####
#   # # #   # # #     #   #     #   #   #   # # # #     #   #   # #     # # #     #     #   #   #   #
# ### ##### # # ### ### ##### ### ######### # # # ##### # ### ### ### ########### ####### # # # # ###
# #     #             # #   # #       #     #   #       #   #   #         #         #     # # # #   #
# ### ### ############### # ### # ##### # ### # ####### ####### # ### ####### # ############# ##### #
# #   #         #     #   #   # #     # #   # # #           #     #     #     #   #     #   # #     #
# ##### ### ######### # ############# # # ### # ### ### ### ### ##### # ##### ####### ##### # # ### #
#   #   # #         # #     #     #     #   # #     #     #   #   #   #   #       # #       # # #   #
### ##### # ### # # # ### # ### ######### # # # ####### ##### # ### ##### ### ### # # ####### ##### #
# #     #   # # # #     # #     #       # #   # #   #   # #   # # #     #   # #         # # #       #
# # ####### # ### ### # ####### ### ### ##### ##### # ### # ##### # ####### ##### # ##### # ### #####
#     #     #     #   #   #   #     # #   # # # #     # #     #       #   #   # # #       #   # #   #
# ### ### ### ### ########### ### ### # # # # # ### ### # # ##### ##### ##### # ############# # # ###
#   # #   # #   # # #           # #   # # #   #     #     #   # #       #     #   # #     #     # # #
### ##### # ####### ##### ### ####### # # # ############# ### # # # # #### #### ### # # # ### ### # #
#       # #   #   # #   # #       # # # #       # #         # # # # # #     #         # # #         #
# ### ### # ### ### # ### ######### # ##### ##### ### # ####### ##### ### ##### ### ##### ##### # # #
# #   #     # #       # #       #     # #       #   # #     # #     # #       # #   #       #   # # #
# # # ##### # ####### # ####### ### ### ### ### # ##### # ### ##### # # ### ### ##### # # ##### ### #
# # #           #   #   #   #   #   # #       # #     # #   #   #   #   #     # # #   # #       #   #
### ### ##### # # ### # # ##### # ### ### ##### ### ####### ### # ### ### ####### # ##### # # ##### #
#     # #   # # # #   # #   #       #   # # #     # #   # # #     #     #   #   #   # #   # # #     #
# ### ### ### ### ### # # ### ####### # # # ####### # ### ##### ### ######### # ##### # # # # # #####
#   # #   #   #     # #     # # # #   # #     # #     #           # # #     # #     # # # # # #   # #
### # ### ### # # ### # # ### # # ### ### # ### ##### # ######### ### ### # # ####### ### ### ##### #
# # # #       # # # # # #       # #   # # #     # #   #   # # # #       # #   #       #   #   # #   #
# ### ### ### ### # # ##### ### # # ### ### ##### ### # ### # # ### ####### # # # ##### ### # # ### #
#   #   #   #     # #   # #   #     # #         # #   #       # # # #       # # #         # # #     #
# ####### ######### # ### ### # ##### ##### ### # ### # ### # # # ### ### # ####### ##### ### # # ###
#   #         #         #     # #     # # # #   #       #   #   #   # #   # # #   # #   #   #   #   #
# # ##### # ### ### # # ##### # ### ### # # # ### ######### ### # # ### ##### ### # # ### ###########
# #   # # #   # #   # #     # #             #   #     #     #     # #   # #   #         #   #   #   #
# # # # ######### ### # ##### # ####### # ##### # # # ####### # # ##### # # # ########### ### ### # #
# # # #           #   #   #   # #   #   #   # # # # #       # # #   #       #   #   #     #   # # # #
##### ##### # ### ##### ######### ### # ##### # ### # # ### ### # ##### # ##### ### ##### ### # # ###
#     #   # # #   # #     #   # #   # # # #   # #   # # #   #   #       # #   #         # # # # #   #
### # # ######### # ##### ### # ### # ### # ####### # ### ##### # # ### ### # # ### # # # # # # ### #
#   # #       # #     #           #   #   # #   #   #   # #     # # # #     # #   # # # # #         #
### ##### # ### # # # # ### ######### # # # # ### # # ### ########### # ### ### # ##### # # # #######
#       # #     # # # # #     #         #   # #   # #   # #   #   # # # #     # # # # # # # #   #   #
# ### # ####### # ### ##### ######### # # ### ### ##### ### # # ### # ##### ##### # # ### # ##### ###
# # # # #     # # #   # #   #   #   #   #     # # #   #     # #     #       #       #   # #   # #   #
# # ### # ##### ####### ### ### # ######### # # ### # # ### # ### ##### ##### ### ### ####### # ### #
#   # # #     #         #     #         # # #   # # #   #   # #       # #       #   #       #   #   #
# # # # ### ##### ### ### # ### ### ### # # ##### ### ##### # ### # # ######### ######### ### # # ###
# # #         #     # # # #   #   # #   # #   #   # # #   # #   # # #       #         #     # # #   #
####### ### # ### ##### ### ### # ### # # # ##### # # # ### ########### ########### # ### ### ### # #
#   #   # # #         #   # #   #   # # #           #     #       #   #     # #     #   #     #   # #
# ### ### # ########### # # ####### ### # # ### # ### # ### ### ### ### # ### # ####### # # # # # ###
#   #   #   #         # #     #       #   # # # # #   # # # #   #     # # #   # #     # # # # # #   #
# ### ##### ### # # # ### ######### # ####### ### # # # # # ### # ### # ### ##### ##### ### ##### ###
#   # #   #   # # # #   # #     #   #       #       # # # #   #     # # #               # #   #   # #
### # ### ### # ### ##### # ### # ### ####### ### ####### ####### # ### # ####### ### ### # ### ### #
# # #     #     # #         #   # #     # #   # # #               #   #       #   #             #   #
# # ##### ### # # # ##### ############### # # # ##### ####### # ### # ####### ### # ####### # ##### #
#         # # #   #   # #   #       # #     #       #   # #   # #   #   #     # # #       # # #     #
##### ##### ########### ### # # # ### ##### ### # # # # # # ##### ### # # # ### # ##### # # ### ### #
#       # #     #         #   # #       # # #   # # # # #     # #   # #   # #   # # #   # #   # #   #
### # ### # ### # ##### # ######### ### # # ### # ####### # ### # # ####### ### # # ### ########### #
#   #     # #         # #             # #     # #       # # #     #       #   #     #       #       s
#####################################################################################################
